#info

title=Turku
time=70
music=sounds/level3music.mp3
difficulty=Hard

#level
0,0,0,0,0,0,0,B,0,0,M,M,M,M,0,0,0,0,0,0,0,B,0,0,0,0,0,0,0,0,0,0,0,0,0,0,0,0,0,0,0,0,0,0,0,0,0,0,0,0,0,0,0,0,0,0,0,0,0,0,0,0,0,0,0,0,0,0,0,0,0,0,0,0,B,0,0,0,0,0,0,0,0,0,0,0,M,0,0,0,0,0,0,0,0,0,0,0,0,0,0,0,0,
0,0,0,0,0,0,0,M,0,0,0,0,0,0,0,0,0,0,0,0,0,M,0,0,0,0,0,0,0,0,0,0,0,0,0,0,0,0,0,0,0,0,0,0,0,0,0,B,0,0,0,0,0,E,0,0,0,0,0,0,0,0,0,0,0,0,0,0,0,0,0,0,0,G,G,0,0,0,0,0,0,0,0,0,0,0,M,0,0,0,0,0,0,0,0,0,0,0,0,0,0,0,0,
0,0,0,0,0,0,0,0,0,0,0,0,0,0,M,0,0,0,0,0,0,0,0,M,0,0,0,0,0,0,0,0,0,0,0,0,0,0,0,0,0,0,0,0,0,0,0,M,0,0,0,0,0,0,0,0,0,0,0,0,0,0,0,0,0,0,0,0,0,0,0,0,G,G,G,0,0,0,0,0,0,0,0,0,0,0,0,0,0,0,0,0,0,0,0,0,0,0,0,0,0,0,0,
0,0,0,0,0,0,0,0,0,0,0,0,0,0,0,0,0,0,M,0,0,0,0,E,0,0,0,0,0,0,0,0,0,0,0,0,0,0,0,0,0,0,0,0,0,0,0,0,0,0,0,0,0,0,0,0,0,0,0,0,0,0,0,0,0,0,0,0,0,0,0,G,G,G,G,0,0,0,B,0,E,0,0,0,0,0,0,0,0,0,0,0,E,0,0,0,0,0,0,0,0,0,0,
0,0,H,0,0,0,0,0,0,M,0,0,0,0,0,0,0,0,0,0,0,0,0,0,0,0,0,0,0,0,0,0,0,0,0,0,0,0,0,0,0,0,0,0,M,0,0,0,0,0,0,0,0,0,0,0,0,0,0,0,0,B,0,0,0,0,0,0,0,0,G,G,G,G,G,0,0,0,M,0,0,0,0,0,0,0,0,0,0,0,0,0,0,0,0,0,0,0,0,0,0,0,0,
0,0,0,0,0,0,0,0,0,0,0,0,0,0,0,0,E,0,0,0,0,B,0,0,0,B,0,0,0,0,0,0,E,E,0,0,0,0,0,0,0,0,0,0,0,0,0,0,0,0,B,0,0,E,0,0,0,0,0,0,0,0,0,0,0,0,0,0,0,G,G,G,G,G,G,0,0,E,0,0,0,0,0,0,0,0,M,0,0,E,0,0,0,0,0,0,0,0,0,0,0,0,0,
0,0,0,0,0,0,0,0,B,0,0,0,0,0,B,0,0,0,0,0,G,G,G,0,0,M,0,0,0,0,G,0,0,0,M,L,M,0,0,0,0,M,0,0,0,0,0,0,0,0,0,0,0,0,0,0,0,0,0,0,0,0,0,0,0,0,0,0,G,G,G,G,G,G,G,0,0,0,0,0,0,M,0,0,0,0,M,0,0,0,0,0,0,0,E,E,0,0,0,0,X,0,0,
G,G,G,G,G,0,0,0,M,0,0,0,0,0,M,0,0,G,G,G,G,G,G,L,L,L,L,L,G,G,G,0,0,0,M,M,M,0,0,0,0,0,0,0,0,G,L,L,L,L,G,L,L,L,L,G,0,0,0,B,0,0,0,B,0,0,0,G,G,G,G,G,G,G,G,L,L,L,L,L,L,L,L,L,L,L,G,G,G,G,G,G,G,G,G,G,G,G,G,G,G,G,G,
0,0,0,0,0,0,0,0,0,0,0,0,0,0,0,0,0,0,0,0,0,0,0,0,0,0,0,0,0,0,0,0,0,0,0,0,0,0,0,0,0,0,0,0,0,0,0,0,0,0,0,0,0,0,0,0,0,0,0,G,0,0,0,G,0,0,0,0,0,0,0,0,0,0,0,0,0,0,0,0,0,0,0,0,0,0,0,0,0,0,0,0,0,0,0,0,0,0,0,0,0,0,0,
