#info

title=Ulaanbaatar
time=120
music=sounds/level4music.mp3
difficulty=Impossible

#level
0,0,0,0,0,0,0,0,0,0,0,0,0,0,0,0,0,0,0,0,0,0,0,0,B,0,0,0,R,R,R,R,R,R,R,R,R,R,R,R,R,R,R,0,0,R,R,R,R,R,0,0,0,B,0,0,0,0,0,0,0,0,0,0,0,0,0,0,0,0,0,0,0,0,0,0,0,0,B,0,0,0,0,0,0,0,0,0,0,0,0,0,0,0,0,0,0,0,0,0,0,0,0,0,0,0,0,0,0,0,0,0,0,0,0,0,0,0,0,0,0,0,0,0,0,0,0,0,0,0,0,0,E,0,0,0,0,0,0,0,0,0,0,0,0,0,0,0,0,0,0,0,0,0,0,0,0,0,0,0,0,0,0,0,0,0,0,0,0,0,0,0,0,0,0,0,0,0,E,E,E,E,E,E,E,E,E,E,E,E,E,E,E,E,E,E,E,E,E,0,0,0,0
0,0,H,0,0,0,B,E,0,0,0,0,0,0,0,0,0,0,B,0,0,0,0,M,M,M,0,0,R,R,R,R,R,R,R,R,R,R,R,R,R,R,R,0,0,R,R,R,R,R,0,0,0,M,0,0,0,0,0,0,0,0,0,0,0,0,0,0,0,0,0,0,0,0,M,0,0,0,0,0,0,0,0,0,0,0,0,0,0,0,0,0,0,0,0,0,0,0,0,0,0,0,0,0,0,0,0,0,0,0,0,0,0,0,0,0,0,0,0,0,0,0,0,0,0,0,0,0,0,0,0,0,R,0,0,0,0,0,0,0,0,0,0,0,0,0,0,0,0,0,0,0,0,0,0,0,0,0,0,0,0,0,0,0,B,0,0,0,0,B,0,0,0,0,0,B,0,0,0,0,0,0,0,0,0,0,0,0,0,0,0,0,0,0,0,0,0,0,0,0,0,0,0
0,0,0,0,0,0,M,0,0,0,0,0,0,0,0,0,0,0,0,0,0,0,0,0,0,0,0,0,0,0,0,0,0,0,0,0,0,0,0,0,0,0,0,0,0,0,0,0,R,R,0,0,0,0,0,0,0,0,0,0,0,0,0,0,0,0,0,0,0,0,0,0,0,0,0,M,0,E,0,0,0,0,0,0,0,0,0,0,0,0,0,0,0,0,0,0,0,0,0,0,0,0,0,0,0,0,0,0,0,0,0,0,0,0,0,0,0,0,0,0,0,0,0,0,0,B,0,0,R,0,0,0,R,0,0,0,0,0,0,0,0,0,0,0,0,0,E,0,B,0,E,0,0,0,0,B,0,0,0,0,0,0,0,S,S,S,S,S,S,S,S,0,0,0,0,0,0,0,0,0,0,0,0,0,0,0,0,0,0,0,0,0,0,0,0,0,0,0,0,0,0,0,0
0,0,0,0,E,0,0,M,0,0,0,0,0,E,0,0,0,0,0,0,0,0,0,0,0,0,0,0,0,0,0,0,0,0,0,0,0,0,0,0,0,0,0,0,M,0,0,0,0,R,0,0,0,0,0,0,0,0,0,0,0,0,0,0,0,0,0,0,0,0,0,0,B,0,0,0,M,0,0,0,0,0,B,0,0,0,0,0,0,0,0,0,0,E,0,0,0,E,0,0,0,0,0,B,0,0,B,0,0,M,0,E,0,0,B,0,0,0,0,0,0,S,0,0,0,S,0,0,R,0,0,0,R,0,0,0,0,B,0,0,0,0,0,0,M,0,0,0,M,0,0,0,M,0,0,0,0,0,0,0,0,0,S,S,S,S,S,S,S,S,S,S,0,0,0,0,0,0,0,0,0,0,0,0,0,0,0,0,0,0,0,0,0,0,0,0,0,0,0,0,0,0,0
0,0,M,0,0,0,0,0,M,0,0,B,0,S,0,S,0,0,0,0,0,0,0,0,0,0,0,0,0,0,0,0,0,0,0,0,0,0,0,0,0,0,0,0,0,0,0,0,0,0,E,0,0,0,0,0,0,0,0,0,0,0,0,0,0,0,0,0,0,0,0,0,M,0,0,0,0,M,0,0,0,0,M,0,0,0,0,0,0,0,0,B,0,E,0,0,0,E,0,0,0,0,0,0,0,0,M,0,0,0,0,0,E,0,0,0,0,0,B,0,0,0,0,0,0,0,0,0,R,0,0,0,0,0,0,0,0,R,0,0,0,0,0,E,0,0,0,0,0,0,0,0,0,E,0,0,0,0,0,0,0,S,S,S,S,S,S,S,S,S,S,S,S,0,0,0,0,0,0,0,B,0,0,0,B,0,0,0,B,0,0,0,B,0,0,0,X,0,0,0,0,0,0
0,0,0,0,0,0,0,0,0,0,0,M,0,0,0,0,0,0,0,0,0,0,0,0,0,0,0,0,0,0,0,0,0,0,B,0,0,0,B,0,0,0,0,0,0,0,0,0,B,0,E,0,0,0,0,0,0,0,B,0,0,0,0,0,0,0,0,0,0,0,0,E,0,0,0,0,0,0,M,0,0,0,0,0,R,L,L,L,R,0,0,R,0,0,0,R,0,0,0,R,0,0,0,0,0,0,0,0,0,0,0,0,0,E,0,0,0,0,M,0,0,0,0,0,0,0,0,0,R,0,0,0,0,0,0,0,R,R,0,0,0,0,M,0,0,0,0,0,0,0,0,0,0,0,E,0,0,0,0,0,S,S,S,S,R,L,L,L,R,S,S,S,S,S,0,0,0,0,M,M,M,M,M,M,M,M,M,M,M,M,M,M,M,M,M,M,M,M,M,0,0,0,0
0,0,0,0,0,0,0,0,0,0,0,0,0,0,0,0,0,0,0,0,0,M,0,0,B,0,0,R,R,R,R,R,L,L,R,R,L,L,M,L,L,R,R,R,R,R,R,R,0,0,E,0,0,0,0,0,0,0,M,0,0,B,0,0,0,0,0,0,0,0,0,0,0,0,0,0,0,0,0,0,0,0,0,0,R,L,L,L,R,0,0,0,0,0,0,0,0,0,0,0,0,0,0,0,0,0,0,0,0,0,0,0,0,0,0,0,0,0,0,0,0,0,0,0,0,0,0,0,R,0,0,0,0,0,R,R,R,R,0,0,0,0,0,0,0,0,0,0,0,0,0,0,0,0,0,E,0,0,0,S,S,S,S,S,R,R,R,R,R,S,S,S,S,S,S,0,0,0,0,0,0,0,0,0,0,0,0,0,0,0,0,0,0,0,0,0,0,0,0,0,0,0,0
L,L,L,L,L,L,L,L,L,L,L,L,L,L,L,L,L,L,L,L,L,L,G,G,G,G,R,R,R,R,R,R,R,R,R,R,R,R,R,R,R,R,R,R,R,R,R,R,R,R,L,L,L,L,L,L,L,L,L,L,L,R,0,0,0,0,0,0,0,R,L,L,L,L,L,L,L,L,L,L,L,L,L,L,R,L,L,L,R,L,L,L,L,L,L,L,L,L,L,L,L,G,G,G,G,G,L,L,L,L,L,L,L,L,L,G,L,L,L,L,L,L,L,L,L,L,L,L,R,L,L,R,R,R,R,R,R,R,L,L,L,L,L,L,L,L,L,L,L,L,L,L,L,L,L,L,G,G,S,S,S,S,S,S,S,S,S,S,S,S,S,S,S,S,S,S,0,0,E,E,E,E,E,E,E,E,E,E,E,E,E,E,E,E,E,E,E,E,E,0,0,0,0
0,0,0,0,0,0,0,0,0,0,0,0,0,0,0,0,0,0,0,0,0,0,0,0,0,0,0,0,0,0,0,0,0,0,0,0,0,0,0,0,0,0,0,0,0,0,0,0,0,0,0,0,0,0,0,0,0,0,0,0,0,0,G,G,G,G,G,G,G,0,0,0,0,0,0,0,0,0,0,0,0,0,0,0,0,0,0,0,0,0,0,0,0,0,0,0,0,0,0,0,0,0,0,0,0,0,0,0,0,0,0,0,0,0,0,0,0,0,0,0,0,0,0,0,0,0,0,0,0,0,0,0,0,0,0,0,0,0,0,0,0,0,0,0,0,0,0,0,0,0,0,0,0,0,0,0,0,0,0,0,0,0,0,0,0,0,0,0,0,0,0,0,0,0,0,0,0,0,0,0,0,0,0,0,0,0,0,0,0,0,0,0,0,0,0,0,0,0,0,0,0,0,0